39 39
S        #   # # #     #       # # # # 
 # ### ### ### # # ##### ### ### # # # 
 #   # # #   #   #         #   #     # 
## ##### # ### ### ############# # # # 
     #               #   #   #   # #   
 ### # ##### ### ### # # # ### ### # # 
 #       # #   #   #   #         # # # 
## # # ### # ############# ############
   # #     #       # #   # #   # #   # 
 ### # # ####### # # # ##### ### # ### 
 # # # #       # #               #   # 
 # ##### # # ##### # ####### ####### # 
   # # # # #     # #     # # #   #     
 # # # # # ### # ### ##### ##### ##### 
 #     # #   # # #           # #       
## # # ############# ######### # ### # 
   # #     #     #             # # # # 
 # ####### # ########### ####### # ### 
 #   #   #       # #   #     #       # 
 ### ### # ### ### ### # ##### # # ####
   #   #   #         #         # # #   
 # # ### ####### # # ### # ### ##### # 
 # #   #     # # # #   # #   #       # 
 ######### ### ### # # ##### # ### # ##
       #   #     # # #   # # # # # #   
 ### ##### ##### ### ##### ### # ##### 
   # #             #     #   #       # 
 ######### # ### ### # ##### ##### # ##
         # #   #   # #           # #   
 # ### # # ####### ##### ##### ##### ##
 #   # # #     #       #     # #       
 ####### ##### # # # # # ### ##########
       #   # # # # # # # #             
 ######### # ### # ##### # # # # ##### 
       #       # #     # # # # #     # 
 ### ### # ##### # ######### ### # # # 
   #   # #   #   #       #     # # # # 
 ##### # ### ####### # # # # ### # ### 
     # #   #   #     # # # #   # # #  E
